++++++++++++++++++++++
+  +  ++ ++           
+            +++++++ +
+ +   ++ ++++ +++ ++ +
+ + +   ++  +++ +    +
+     +    ++ + +    +
+++++ + +  ++ + +    +
+++++ +++   + ++ +      
+       + + S+ + +    
+++++ + + + + + +               
++++++++++++++++++++++